0000000000
0000000000
0000010000
0000010000
0001110000
0000010000
0000010000
0000010000
0000000000
0000000000
